AGD	artykuły gospodarstwa domowego	brev:npun
CV	curriculum vitae	brev:npun
Corp	corporation	brev:pun
EKG	elektrokardiogram	brev:npun
N	narzędnik	brev:pun
N	niuton	brev:npun
OK	okay	brev:npun
PS	postscriptum	brev:npun
USG	ultrasonografia	brev:npun
V	wolt	brev:npun
W	wat	brev:npun
WF	wychowanie fizyczne	brev:npun
aa	ad acta	brev:npun
abl	ablativus	brev:pun
abp	arcybiskup	brev:npun
ac	a capite	brev:npun
acc	accusativus	brev:pun
accel	accelerando	brev:pun
ad	adiunkt	brev:pun
adm	administracyjny	brev:pun
adv	adverbium	brev:pun
adw	adwokat	brev:pun
afr	afrykański	brev:pun
agd	artykuły gospodarstwa domowego	brev:pun
akad	akademicki	brev:pun
aktl	aktualizacja	brev:pun
al	aleja	brev:pun
alb	albański	brev:pun
am	amerykański	brev:pun
amer	amerykański	brev:pun
anat	anatomiczny	brev:pun
and	andante	brev:pun
ang	angielski	brev:pun
ap	apostoł	brev:pun
apost	apostoł	brev:pun
ar	arabski	brev:pun
arab	arabski	brev:pun
arch	archaiczny	brev:pun
archeol	archeologiczny	brev:pun
archip	archipelag	brev:pun
archit	architekt	brev:pun
arcyks	arcyksiążę	brev:pun
ark	arkusz	brev:pun
art	artykuł	brev:pun
artyst	artystyczny	brev:pun
asb	apostilb	brev:npun
astr	astronomiczny	brev:pun
astron	astronautyczny	brev:pun
atm	atmosferyczny	brev:pun
austr	austriacki	brev:pun
azerb	azerbejdżański	brev:pun
azj	azjatycki	brev:pun
azjat	azjatycki	brev:pun
b	bar	brev:npun
b	bardzo	brev:pun
b	bieżący	brev:pun
b	były	brev:pun
bałt	bałtycki	brev:pun
bd	bardzo dobry	brev:npun.pun
bdb	bardzo dobry	brev:pun
bhp	bezpieczeństwo i higiena pracy	brev:npun
bibl	biblioteka	brev:pun
blm	bez liczby mnogiej	brev:pun
bln	bilion	brev:npun
blp	bez liczby pojedynczej	brev:pun
bm	bieżącego miesiąca	brev:pun
bp	biskup	brev:npun
bpstwo	bpstwo	brev:npun
br	bieżącego roku	brev:pun
bryt	brytyjski	brev:pun
bł	błogosławiony	brev:pun
bł	błąd	brev:pun
błp	błogosławionej pamięci	brev:pun
c	circa	brev:pun
ca	circa	brev:npun
cd	candela	brev:npun
cd	ciąg dalszy	brev:pun
cdn	ciąg dalszy nastąpi	brev:pun
cel	celujący	brev:pun
centr	centralny	brev:pun
ces	cesarski	brev:pun
cf	confer	brev:pun
cg	centygram	brev:npun
chem	chemiczny	brev:pun
chir	chirurgiczny	brev:pun
chiń	chiński	brev:pun
chor	chorąży	brev:pun
chrz	chrześcijański	brev:pun
chrześc	chrześcijański	brev:pun
cieśn	cieśnina	brev:pun
ciśn	ciśnienie	brev:pun
ck	cesarsko-królewski	brev:npun.pun
ckm	ciężki karabin maszynowy	brev:npun
clg	kologarytm	brev:npun
cm	centymetr	brev:npun
colog	kologarytm	brev:npun
cos	cosinus	brev:npun
cosec	cosecans	brev:npun
cosh	cosinus hiberboliczny	brev:npun
ctg	cotangens	brev:npun
cyg	cygański	brev:pun
cyw	cywilny	brev:pun
cz	część	brev:pun
czes	czeski	brev:pun
czw	czwartek	brev:pun
czyt	czytaj	brev:pun
dag	dekagram	brev:npun
dalm	dekalumen	brev:npun
daw	dawniej	brev:pun
db	dobry	brev:pun
dcg	decygram	brev:npun
dcl	decylitr	brev:npun
dcm	decymetr	brev:npun
dcn	dalszy ciąg nastąpi	brev:pun
dedyk	dedykacja	brev:pun
dekl	deklinacja	brev:pun
deleg	delegat	brev:pun
demogr	demograficzny	brev:pun
demokr	demokratyczny	brev:pun
dent	dentystyczny	brev:pun
dep	departament	brev:pun
det	detaliczny	brev:pun
dg	decygram	brev:npun
dh	druh	brev:npun
diec	diecezja	brev:pun
dkg	dekagram	brev:npun
dkl	dekalitr	brev:npun
dkm	dekametr	brev:npun
dl	decylitr	brev:npun
dm	decymetr	brev:npun
dn	dnia	brev:pun
doc	docent	brev:pun
dop	dopełniacz	brev:pun
dost	dostateczny	brev:pun
dosł	dosłownie	brev:pun
dot	dotyczy	brev:pun
dpi	dots per inch	brev:npun
dr	doktor	brev:npun
ds	do spraw	brev:pun
dst	dostateczny	brev:pun
duszp	duszpasterz	brev:pun
dwt	deadweight tonnage	brev:npun
dwumies	dwumiesięcznik	brev:pun
dypl	dyplomowany	brev:pun
dyr	dyrektor	brev:pun
dyryg	dyrygent	brev:pun
dyskw	dyskwalifikacja	brev:pun
dyw	dywizja	brev:pun
dz	dziennik	brev:pun
dziec	dziecięcy	brev:pun
dziek	dziekan	brev:pun
dzis	dzisiejszy	brev:pun
dł	długość	brev:pun
egz	egzemplarz	brev:pun
ekg	elektrokardiogram	brev:pun
ekol	ekologiczny	brev:pun
ekon	ekonomiczny	brev:pun
ekum	ekumeniczny	brev:pun
elbl	elbląski	brev:pun
elektr	elektryczny	brev:pun
em	emerytowany	brev:pun
emigr	emigracyjny	brev:pun
encykl	encyklopedia	brev:pun
epid	epidemia	brev:pun
erl	erlang	brev:npun
etc	et cetera	brev:pun
etiop	etiopski	brev:pun
etnogr	etnograficzny	brev:pun
etym	etymologiczny	brev:pun
ew	ewentualny	brev:pun
ewang	ewangelicki	brev:pun
ewent	ewentualny	brev:pun
ewid	ewidencja	brev:pun
fab	fabularny	brev:pun
fabr	fabryka	brev:pun
farm	farmaceutyczny	brev:pun
fenic	fenicki	brev:pun
filh	filharmonia	brev:pun
filol	filologiczny	brev:pun
filoz	filozoficzny	brev:pun
finans	finansowy	brev:pun
fiz	fizyczny	brev:pun
fizjol	fizjologiczny	brev:pun
fiń	fiński	brev:pun
fm	femtometr	brev:npun
fonet	fonetyczny	brev:pun
fot	fotografia	brev:pun
fotogr	fotograficzny	brev:pun
fr	francuski	brev:pun
fragm	fragment	brev:pun
ft	stopa	brev:npun
g	godzina	brev:pun
g	gram	brev:npun
gastr	gastronomia	brev:pun
gat	gatunek	brev:pun
gdań	gdański	brev:pun
gen	generał	brev:pun
genet	genetyczny	brev:pun
geofiz	geofizyczny	brev:pun
geogr	geograficzny	brev:pun
geol	geologiczny	brev:pun
geom	geometryczny	brev:pun
germ	germański	brev:pun
gim	gimnazjum	brev:pun
gimn	gimnastyczny	brev:pun
gimn	gimnastyka	brev:pun
gin	ginekologia	brev:pun
gin	ginekologiczny	brev:pun
ginek	ginekologiczny	brev:pun
gm	gmina	brev:pun
godz	godzina	brev:pun
gosp	gospodarczy	brev:pun
gosp	gospodarka	brev:pun
gr	grecki	brev:pun
gr	grosz	brev:npun
gram	gramatyka	brev:pun
grec	grecki	brev:pun
górn	górnictwo	brev:pun
gł	główny	brev:pun
głęb	głębokość	brev:pun
hab	habilitowany	brev:pun
handl	handlowy	brev:pun
hebr	hebrajski	brev:pun
hetm	hetman	brev:pun
hg	hektogram	brev:npun
hind	hinduski	brev:pun
hist	historyczny	brev:pun
hiszp	hiszpański	brev:pun
hl	hektolitr	brev:npun
hm	harcmistrz	brev:pun
hm	hektometr	brev:npun
hod	hodowlany	brev:pun
holend	holenderski	brev:pun
hondur	honduraski	brev:pun
hot	hotelowy	brev:pun
hp	horse power	brev:npun
hr	hrabia	brev:pun
hrab	hrabstwo	brev:pun
http	HyperText Transfer Protocol	brev:npun
ib	ibidem	brev:pun
ibid	ibidem	brev:pun
id	idem	brev:pun
ie	indoeuropejski	brev:pun
ilustr	ilustracja	brev:pun
im	imienia	brev:pun
im	imiesłów	brev:pun
imiesł	imiesłów	brev:pun
in	inaczej	brev:pun
inf	infinitivus	brev:pun
inf	informatyczny	brev:pun
inform	informatyczny	brev:pun
init	initio	brev:pun
insp	inspektor	brev:pun
inst	instytut	brev:pun
instr	instruktor	brev:pun
inv	invenit	brev:pun
inż	inżynier	brev:pun
iron	ironiczny	brev:pun
itd	i tak dalej	brev:pun
itp	i tym podobne	brev:pun
jez	jezioro	brev:pun
jn	jak niżej	brev:pun
jp	jak poprzednio	brev:pun
jr	junior	brev:npun
jun	junior	brev:pun
jw	jak wyżej	brev:pun
jęz	językowy	brev:pun
k	koło	brev:pun
kadm	kontradmirał	brev:pun
kan	kanalizacyjny	brev:pun
kan	kanonik	brev:pun
kard	kardynał	brev:pun
kat	katolicki	brev:pun
katol	katolicki	brev:pun
kb	kilobit	brev:npun
kbar	kilobar	brev:npun
kbk	karabinek	brev:npun
kbks	karabinek sportowy	brev:npun
kc	kodeks cywilny	brev:pun
kcal	kilokaloria	brev:npun
kcz	kompania czołgów	brev:pun
kdyn	kilodyna	brev:npun
kg	kilogram	brev:npun
kier	kierownik	brev:pun
kk	kodeks karny	brev:pun
kl	klarnet	brev:pun
kl	klasa	brev:pun
klas	klasyczny	brev:pun
km	kilometr	brev:npun
kmdr	komandor	brev:npun
kmdt	komendant	brev:npun
kol	kolega	brev:pun
kom	komisarz	brev:pun
kp	kilopond	brev:npun
kpc	kodeks postępowania cywilnego	brev:pun
kpr	kapral	brev:pun
kpt	kapitan	brev:pun
kr	karat	brev:npun
kr	kodeks rodzinny	brev:pun
kr	krakowski	brev:pun
krak	krakowski	brev:pun
kryt	krytyczny	brev:pun
ks	ksiądz	brev:pun
ks	książę	brev:pun
kult	kultowy	brev:pun
kult	kulturalny	brev:pun
laic	laicki	brev:pun
lek	lekarz	brev:pun
lic	licencjat	brev:pun
lic	liceum	brev:pun
lm	liczba mnoga	brev:pun
lp	liczba  pojedyczna	brev:pun
m	metr	brev:npun
mar	marynarz	brev:pun
max	maximum	brev:pun
mbar	milibar	brev:npun
mec	mecenas	brev:pun
mg	miligram	brev:npun
mgr	magister	brev:npun
mies	miesięcznie	brev:pun
min	minimum	brev:pun
min	minuta	brev:npun
mjr	major	brev:npun
ml	mililitr	brev:npun
mld	miliard	brev:npun
mln	milion	brev:npun
mm	milimetr	brev:npun
mrn	mierny	brev:pun
n	nad	brev:pun
n	nauk	brev:pun
n	nijaki	brev:pun
nacz	naczelny	brev:pun
nagr	nagroda	brev:pun
nb	notabene	brev:pun
ndp	nieodpowiednie	brev:pun
ndst	niedostateczny	brev:pun
niem	niemiecki	brev:pun
np	na przykład	brev:pun
nr	numer	brev:npun
nt	na temat	brev:pun
o	ocean	brev:pun
o	ojciec	brev:pun
ob	obecny	brev:pun
ob	obywatel	brev:pun
obj	objętość	brev:pun
odc	odcinek	brev:pun
ogn	ogniomistrz	brev:pun
ok	około	brev:pun
oo	ojcowie	brev:pun
op	opus	brev:pun
opr	opracował	brev:pun
oprac	opracował	brev:pun
os	osiedle	brev:pun
osk	oskarżony	brev:pun
p	pan	brev:pun
p	patrz	brev:pun
p	piętro	brev:pun
p	punkt	brev:pun
par	paragraf	brev:pun
pchor	podchorąży	brev:pun
pkt	punkt	brev:npun
pl	plac	brev:pun
plur	pluralis	brev:pun
plut	plutonowy	brev:pun
pm	pistolet maszynowy	brev:npun
pn	patrz niżej	brev:pun
podinsp	podinspektor	brev:pun
podst	podstawowy	brev:pun
pok	pokój	brev:pun
pon	poniedziałek	brev:pun
por	porównaj	brev:pun
pos	poseł	brev:pun
pow	powiat	brev:pun
pow	powierzchnia	brev:pun
powt	powtórnie	brev:pun
poz	pozycja	brev:pun
pp	państwo	brev:pun
ppanc	przeciwpancerny	brev:pun
ppor	podporucznik	brev:pun
ppoż	przeciwpożarowy	brev:pun
ppłk	podpułkownik	brev:npun
prez	prezydent	brev:pun
prob	proboszcz	brev:pun
proc	procent	brev:pun
prod	produkcji	brev:pun
prof	profesor	brev:pun
proj	projekt	brev:pun
przeł	przełęcz	brev:pun
przym	przymiotnik	brev:pun
przyp	przypadek	brev:pun
przyp	przypis	brev:pun
ps	pseudonim	brev:pun
pt	pod tytułem	brev:pun
pw	patrz wyżej	brev:pun
pózn	późniejszy	brev:pun
płd	południe	brev:pun
płd	południowy	brev:pun
płk	pułkownik	brev:npun
płn	północ	brev:pun
płn	północny	brev:pun
płw	półwysep	brev:pun
r	rok	brev:pun
red	redaktor	brev:pun
ref	referat	brev:pun
ref	referent	brev:pun
reż	reżyser	brev:pun
rodz	rodzaj	brev:pun
rodz	rodzina	brev:pun
rozdz	rozdział	brev:pun
rozm	rozmiar	brev:pun
rtg	rentgen	brev:pun
ryc	rycina	brev:pun
rys	rysunek	brev:pun
s	sekunda	brev:npun
s	strona	brev:pun
scil	scilicet	brev:pun
sek	sekunda	brev:pun
sen	senator	brev:pun
sierż	sierżant	brev:pun
sob	sobota	brev:pun
sp	spółka	brev:pun
spec	specjalista	brev:pun
spr	sprawdzone	brev:pun
st	stacja	brev:pun
st	stołeczny	brev:pun
staroż	starożytny	brev:pun
str	strona	brev:pun
szer	szerokość	brev:pun
sześc	sześcienny	brev:pun
szt	sztuka	brev:pun
sł	słowo	brev:pun
t	tom	brev:pun
t	tona	brev:npun
tab	tabel	brev:pun
tabl	tablica	brev:pun
techn	techniczny	brev:pun
tel	telefon	brev:pun
telef	telefon	brev:pun
teol	teologiczny	brev:pun
teoret	teoretyczny	brev:pun
tj	to jest	brev:pun
tow	towarzysz	brev:pun
turec	turecki	brev:pun
turkm	turkmeński	brev:pun
tv	telewizja	brev:npun
tydz	tydzień	brev:pun
tyg	tygodniowo	brev:pun
tys	tysięcy	brev:pun
tyt	tytuł	brev:pun
tzn	to znaczy	brev:pun
tzw	tak zwany	brev:pun
tł	tłumaczył	brev:pun
ub	ubiegły	brev:pun
uczn	uczniowski	brev:pun
ufo	niezidentyfikowany obiekt latający	brev:npun
ukr	ukraiński	brev:pun
ul	ulica	brev:pun
uniw	uniwersytet	brev:pun
ur	urodzony	brev:pun
urb	urbanistyczny	brev:pun
urz	urzędowy	brev:pun
usg	ultrasonografia	brev:pun
uzup	uzupełnienie	brev:pun
v	vel	brev:pun
v	velocity	brev:npun
v	vide	brev:pun
vol	volumen	brev:pun
w	wiek	brev:pun
wachm	wachmistrz	brev:pun
warsz	warszawski	brev:pun
wet	weterynarz	brev:pun
weter	weterynaryjny	brev:pun
wew	wewnętrzny	brev:pun
wewn	wewnętrzny	brev:pun
wf	wychowanie fizyczne	brev:pun
wg	według	brev:npun
wiceadm	wiceadmirał	brev:pun
wicedyr	wicedyrektor	brev:pun
wicemin	wiceminister	brev:pun
wielkop	wielkopolski	brev:pun
wielkopol	wielkopolski	brev:pun
wlkp	wielkopolski	brev:pun
woj	województwo	brev:pun
ws	w sprawie	brev:pun
wsch	wschodni	brev:pun
wsp	współczesny	brev:pun
wt	wtorek	brev:pun
ww	wyżej wymieniony	brev:pun
wyd	wydanie	brev:pun
wydz	wydział	brev:pun
wyjąt	wyjątkowo	brev:pun
wym	wymowa	brev:pun
wys	wysokość	brev:pun
wz	w zastępstwie	brev:pun
wzg	względnie	brev:pun
węg	węgierski	brev:pun
wł	właściciel	brev:pun
zach	zachodni	brev:pun
zagr	zagraniczny	brev:pun
zakł	zakładowy	brev:pun
zal	zaliczony	brev:pun
zam	zamieszkały	brev:pun
zapł	zapłacony	brev:pun
zarz	zarząd	brev:pun
zarz	zarządzenie	brev:pun
zazw	zazwyczaj	brev:pun
zał	załącznik	brev:pun
zdj	zdjęcie	brev:pun
zdr	zdrobnienie	brev:pun
zewn	zewnętrzny	brev:pun
zjed	zjednoczenie	brev:pun
zm	zmarły	brev:pun
zn	znaczenie	brev:pun
zob	zobacz	brev:pun
zł	złoty	brev:npun
ćw	ćwiczenie	brev:pun
ćwicz	ćwiczenie	brev:pun
łac	łaciński	brev:pun
śl	śląski	brev:pun
śp	świętej pamięci	brev:pun
śr	średni	brev:pun
śr	środa	brev:pun
średn	średnica	brev:pun
św	święty	brev:pun
żarg	żargonowy	brev:pun
żoł	żołnierz	brev:pun
